111111111111111111111111111111111111111111111111111111111111114200000311111111111111111111111111111111111111111111111111111111111111111111111111
111111111111111111111111111111111111111111111111111111401111111110501111111100201111111100301111111111111111111111111111111111111111111111111111
111111111111111111111111111111111111111400001111111111221111111111001111111111001111111111031111111111011111111111011111111111311111111111111111
111111111111111111111111111111111111111111001111114200001111111111101111111111101111111001100111111000000111111011111111111311111111111111111111
111111111111111111111111111111111111111113301111111102301111111102301111111102201111111104111111111111111111111111111111111111111111111111111111
111111111111111111111111111111111111111100011111111122401111111101101111111001300111111000000111111111301111111111111111111111111111111111111111
111111111111111111111111111111111111110011111111110030232011110031030411110001202111111111000111111111111111111111111111111111111111111111111111
111111111111111111111111111111111111111111111111111001111111111000232011110031030411110031212111111100000111111111111111111111111111111111111111
111111111111111111111111111111100111111113000111111110050111111111011111111100040111111100020111111100111111111111111111111111111111111111111111
111111111111111111111111111111111111110000001111110213300111110203300111111101121111111020001111111040111111111111111111111111111111111111111111
111111111111111111111111111111111111111001111111111022301111111023301111111033201111111032201111111001401111111111111111111111111111111111111111
111111111111111111111111111111111111111001111111111022001111111053301111111033501111111002201111111001401111111111111111111111111111111111111111
111111111111111111111111111111111111111111111111111001100111110020300011110222331011110410300011111111111111111111111111111111111111111111111111
111110011111111114000001111100011001033101011011000002001211100101000011111100011211111111111001111130000001111111111111111111111111111111111111
111111111111111111111111111111111111110011111111100000011111103312011111111002011111111114011111111111111111111111111111111111111111111111111111
111111111111111111111111111111111111111100311111111021311111111000011111111101001111111120401111111100011111111111111111111111111111111111111111
111111111111111111111111111111111111111000001111111020201111111011101111111033121111111133020111111100010111111100040111111111111111111111111111
111111111111111111111111111111111111111111111111111111001111110202022011110101331011110400330011111111111111111111111111111111111111111111111111
111111111111111111111111111111111111111111001111111102201111111031001111111030331111111031001111111122211111111104011111111111111111111111111111
111111111111111111111111111111111111111100111111111130111111111032201111111034101111111032201111111100001111111111111111111111111111111111111111
111111111111111111111111111111111111111110011111111113011111111103220111111003410111111023220111111113000111111111111111111111111111111111111111
111111111111111111111111110001111111110200011111111211011111110233001111110033001111111011111111110200000111110001040111111111111111111111111111
111111111111111111111111111111111111111111001111110020001111110221100111110200100111110220100111110410333111111111333111111111111111111111111111
111111111111111111111111111000000111111011131111111020323111111010054111111012323111111002030111111012111111111000000111111111111111111111111111
111111111111111111111111111111111111111111031111111111001111111102200111111100000111111112101111111113431111111111111111111111111111111111111111
111111111111111111111111111111111111111333341111110020120111110020020111110011000111111111111111111111111111111111111111111111111111111111111111
111111111111111114001111111302031111111002011111111101111111110200111111100000111111130011111111111111111111111111111111111111111111111111111111
111111111111111111111111111111001111110003321111110241020111111233000111111001100111111111111111111111111111111111111111111111111111111111111111
111111111111111111111111111111111111110011111111110300311111110301011111110020011111111221111111111041111111111111111111111111111111111111111111
111111111111111111111111111111111111111110011111111110011111111002220111111033310111111013330111111022241111111110001111111111111111111111111111
111111111111111111111111111104001111110202021111110031301111111031121111111211301111111031301111111231320111111002000111111000111111111111111111
111111111111111111111111111111111111110011000111110000020111110204101111111211101111110203301111110003311111111111111111111111111111111111111111
111111111111111111111111111111111111111103310011111003020011111013110011110223112111110010200011111000104011111111111111111111111111111111111111
111111111111111111111111111000001111111031201111111030201111111031211111111030011111111052211111111134011111111111111111111111111111111111111111
111111111111111111111111111111111111111000001111111031201111111050201111111031211111111050011111111330211111111114011111111111111111111111111111
111111111111111004001111111005001111111113111111110333330111110202020111111102011111111101011111111102011111111102011111111100011111111111111111
111111111111111111111111111111111111111110300111111002310111111012320111111002321111111101301111111104001111111111111111111111111111111111111111
111111111111111111111111130000000011101111131011101005001011103021201011101201021011101021203011101005001011101311111011140000000311111111111111
111111111111111111111111111111111111111110000011111022101011110333330011110101222111110001010111111111040111111111111111111111111111111111111111
111111111111111111111111111111110001100000000241101011111211101033333001101220201001101011111011100000000011111111111111111111111111111111111111
111111111111111111111111100000001111100033331111111030030011111031112411111111000111110002220011110000201011111120200011111100000111111111111111
111111111111111111111111114000000111110535350111110205020111110551550111110205020111110535350011110000000011111111111111111111111111111111111111
111111111111111111111111111111111111111111111111111111031111111111033011111100200311111100010111111112220111111110411111111111111111111111111111
111111111111111111111111111100111111111102011111111032311111111023201111111032301111111114111111111100111111111100111111111100111111111111111111
111111111111111111111111111111111111111000111111103232400111100232300111111010111111111000111111111111111111111111111111111111111111111111111111
111111111111111111111111111111111111111100111111111130111111111030111111111232111111114232001111110230001111111100111111111111111111111111111111
111111111111111111111111111111111111111110001111111110521111111105450011111103500011111110001111111110011111111111111111111111111111111111111111
111111111111111111111111111111111111111104311111111022501111111001301111111000001111111021001111111100311111111111111111111111111111111111111111
111111111111111111111111111110011111110002001111110055501111110030301111111050500111111155500111111102011111111104011111111111111111111111111111
111111111111111111111111111111111111100011100111102000004111112555552111102333332011100010000011111111110011111111111111111111111111111111111111
111111111111111111111111110000011111110111211111110100202011110101202011110103333311110110110011110000400111111111111111111111111111111111111111
111111111111111111111111100000000011101512151011101010101011101004001011105001005011101553551011100001000011111001111111111111111111111111111111
111111111111111111111111111100011111110201020111110130310111110055500111110130310111110201020111111104011111111111111111111111111111111111111111
111111111111111100000111111121012111111020000111111011110111111333200011110333101011110011101011110000001011111110122011111110401111111111111111
111111111111111111111111111111111111111111001111111000201111111013030111111023330111111022121111111110401111111111111111111111111111111111111111
111111111111111111111111111111100011111111121011111111302011111110050011111130503111110205011111110120311111110400111111111111111111111111111111
111111111111111111111111100110001111103200001111102311211111113211011111102300000011103211101011100311104011111111111111111111111111111111111111
111111111111111111111111111111303311111301221011111031002411110202022111113001000111113110000111100023111111100000111111111111111111111111111111
111111111111111111111111110300030111113122213111110203020111112131312111110203020111113122213111110304030111111111111111111111111111111111111111
111111111111111111111111111113111111111005001111110052500111110500050111135201025311110504050111110052500111111005001111111113111111111111111111
111111111111111030201111111010101111111350001111111012101111111024531111111012101111111350001111111010101111111020301111111111111111111111111111
111111111111111111111111111111000111111000000111111211131111110000130111110202030111110010030111111211131111110200001111110401111111111111111111
111111111111111111111111110011111111110200200011110110000311110010011311112012333311110040010111112111110011100000020011100011110011111111111111
111111111111111111111111111100000111111101110111110022010111110223010111110023010111114323010111111113110111111113000111111111111111111111111111
111111111111111111111111111100001111111155530111111020010111111000010111111010110111111022500111111130340111111111111111111111111111111111111111
111111111111111111111111111111111111111113000111110023210111110123200111110023211111111013011111111043011111111111111111111111111111111111111111
111111111111111111111111111111111111111110300111110002310111110112320111110202321111110100301111110111301111110004011111111111111111111111111111
111111111111111111111111111111111111110303030111100230320011102023202011111114111111102023202011100230320011110303030111111111111111111111111111
111111111111111111111111111111111111111100011111111121000111110233010111110033200111110233011111111121211111111104011111111111111111111111111111
111111111111111111111111111111111111111110001111111102101111111132301111111032301111114252300111110101010111110001000111111111111111111111111111
111111111111111111111111111040111111111022000011111101101011111100000011111121233111110002013111110001003311111111111111111111111111111111111111
111111111111111111111111111111111111111140011111111102220011133310200011103210202011113050100011110000011111111133011111111111111111111111111111
111111111111111111111111111111111111111000001111111233321111102031302011101233321011101002001011101121111011100004000011111111111111111111111111
111111111111111111111111111100010001102001000241101100001011101131111011101033331011101020202011101111110011100000000111111111111111111111111111
111111111111111111111111111133000111111101100111110233220111110100020111110235221111110110101111110033401111111111111111111111111111111111111111
111111111111111111111111100010011111102030011111110110011001113312002201112002411331110011031001111111230001111111001111111111111111111111111111
111111111111111111111111110011111111110202020201110103333001110121131111100000031111100011200111111111040111111111111111111111111111111111111111
111111111111111111111111111111111111100411111111101233001111100233100011112233221011110101000011110001001111111111111111111111111111111111111111
111111111111111111111111111005001111100005000011100011100011115054505111100505050011101110111011100105010011110103020111110005000111111111111111
111111111111111111111111111111111111110000111111110353301111110120120011110000323011110120122111110355324111110000111111111111111111111111111111
111111111111100011111111101211000111140000020111111221121111110233102011110133200011110133111011110033000011111110001111111111111111111111111111
111111111111111111111111111111000111110001000111110500051111110551050111110503050111110501550111110502050111111001040111111001111111111111111111
111111111111111111111111111001111111111300111111111550111111110050011111114050000111110055550111111110050111111110020111111110011111111111111111
111111111111111111111111111111001111111003001111111032301111111025211111111134311111111125201111111032301111111002001111111001111111111111111111
111111111111111111111111111100011111111121020001100130300101102231313201104130303111102120100111102000111111111100111111111111111111111111111111
111111111111111111111111111111111111111111111111111100300111111101300111111121101111111020001111111000401111111111111111111111111111111111111111
111111111111111111111111111111111111111100011111111100011111111022111111111010111111111033001111111110401111111111111111111111111111111111111111
111111111111111111111111111111111111111111111111111100411111111101211111111000201111111003031111111111111111111111111111111111111111111111111111
111111111111111111111111111111111111111100111111111100000111111100123111111110103111111000223111111040100111111111111111111111111111111111111111
111111111111111111111111111111111111111111111111111041111111111222000111110331020111110331001111111100001111111111111111111111111111111111111111
111111111111111111111111111111111111111111111111111030301111111020201111111051101111111020200111111034300111111111111111111111111111111111111111
111111111111111111111111111111111111111111111111110001000111110203000111111213111111110203000111114203000111111111111111111111111111111111111111
111111111111111111111111111111111111111111111111110001100011110203330011111211101111110200000111110401000111111111111111111111111111111111111111
111111111111111111111111111111111111111111111111110000000111110233300111111213121111110200000111110001040111111111111111111111111111111111111111
111111111111111111111111111111111111111111111111110001000111110230300111111211120111110230300111110001040111111111111111111111111111111111111111
111111111111111111111111111111111111111111111111110004000111110202020111111313131111110202020111110303030111111111111111111111111111111111111111
111111111111111111111111111111111111111111111111110305030111110054500111110205020111110011100111111111111111111111111111111111111111111111111111
111111111111111111111111111111111111111111111111110305030111110054500111110205020111111100011111111111111111111111111111111111111111111111111111
111111111111111111111111111111111111111111111111111000000011111011111011111213331011110200220011110001340011111111111111111111111111111111111111
111111111111111111111111111111111111111111111111111000000011111011111011111220002011110233331011110001104011111111111111111111111111111111111111
111111111111111111111111111111111111111111111111111032311111111024200111111012010111111030300111111111111111111111111111111111111111111111111111
111111111111111111111111111111111111111111111111111000001111111052520111111010010111111030340111111111111111111111111111111111111111111111111111
111111111111111111111111111111111111111000111111111310001111111020001111111321111111111020011111111340011111111111111111111111111111111111111111
111111111111111111111111111111111111111111111111111100111111111120011111111022011111111013001111111043301111111111111111111111111111111111111111
111111111111111111111111111111111111111111111111111111103111111111100111111111003111111042220111111002303111111111111111111111111111111111111111
111111111111111111111111111111111111111111111111111111001111111111231111111000000111111002230111111401030111111111111111111111111111111111111111
111111111111111111111111111111111111111111111111110303030011110202020011110111114111110202020011110303030011111111111111111111111111111111111111
111111111111111111111111111111111111111111111111111100330111111100330111111110100111111022220111111004100111111111111111111111111111111111111111
111111111111111111111111111111111111111000000111111211010111111301020111111331011111110000020111110401000111111111111111111111111111111111111111
111111111111111111111111111111111111111111401111111002221111111011000111111010010111111003330111111001000111111111111111111111111111111111111111
111111111111111111111111111111111111111111111111111100001111111130201111111131211111111100001111111100401111111111111111111111111111111111111111
111111111111111111111111111111111111111111111111111111111111111113000011100002020011140013011111111111111111111111111111111111111111111111111111
111111111111111111111111111111111111111111111111110001000111110033300111111011011111111002220111111004000111111111111111111111111111111111111111
111111111111111111111111111111111111111111111111111403111111111303000111111220200111111001111111111001111111111111111111111111111111111111111111
111111111111111111111111111111111111111111111111111000000111111013330111111000101111111122201111111100401111111111111111111111111111111111111111
111111111111111111111111111111111111111111111111111110000111111002220111111011010111111003330111111110401111111111111111111111111111111111111111
111111111111111111111111111111111111111111111111111100001111111130201111111031211111111030200111111100400111111111111111111111111111111111111111
111111111111111111111111111111111111111111001111110001001111110333001111111311011111111002220111111111020111111111040111111111111111111111111111
111111111111111111111111111111111111111001001111111330000111110331000111110111011111110002220111111111020111111111040111111111111111111111111111
111111111111111111111111111111111111111110011111100010004111101000012001100011202001100333010001100011111111111111111111111111111111111111111111
111111111111111111111111111111111111111111111111110001111111110200001111111215300111110203300111110401100111111111111111111111111111111111111111
111111111111111111111111111111111111111111111111110001100111110000000111111133330111110222020111110401111111111111111111111111111111111111111111
111111111111111111111111111111111111100001000111100033333111100011101111100001000011111101222011111000242011111000100111111111111111111111111111
111111111111111111111111111111111111111111111111111104011111111122220111111001010111111003333111111001000111111111111111111111111111111111111111
111111111111111111111111111111111111111301000111111002000111111050101111111101023111111000200111111003104111111111111111111111111111111111111111
111111111111111111111111111100100011111030000011111031110111111033010111111211210111110000200111110001210111111111400111111111111111111111111111
111111111111111111111111111111111111111111111111110001000111110203030111111210121111110303020111110000040111111111111111111111111111111111111111
111111111111100011111111101000000011100010111011103330323011110111110111100000022011101220010011104010010011111110011111111111111111111111111111
111111111111111111111111111111111111111111001111111002001111111012100111111302000111111311100111111304001111111111111111111111111111111111111111
111111111111111111111111111111111111111100001111111101101111111000551111111020001111111121331111111101101111111100401111111111111111111111111111
111111111111111100111111111100000111111101100111113300101111113300101111110111101111110102000111110102220111110400100111111111111111111111111111
111111111111111110011111111110000011111110110011111033010111111330010111111011110111111010200011110010222011110040010011111110011111111111111111
111111111111111110011111111110000011111112110011110330010111110330010111111011110111111310200011110010222011110000014011110011111111111111111111
111111111111111110010011111110000011111113110011103310010111103320010111110111110111110102020111110102420011110000100011111000111111111111111111
111111111111111110010011111110020011111110110011103313010111103303010111110111110111110102022011110100420011110002100011111000111111111111111111
111111111111111111111111111111111111110000000011110101011011110505050011110505050111130515020111100005041111111111111111111111111111111111111111
111111111111111111111111111111111111111000001111111010101111111023101111111120301111111145011111111110011111111111111111111111111111111111111111
111111111111111111111111111111111111111111111111111000000111111235320111111050501111110235321111110004001111111111111111111111111111111111111111
111111111111100010001001102000000001112111111001113531100011113350102001111334112101100011110001102000110111100100200011111100100011111111111111
111111111111111111111111111111111111111100111111100353140011100310221011110110100011110000200111110010001111111111111111111111111111111111111111
111111111111111111111111110030303011110020202011111311111111110000020011114020000011111111113111110202020011110303030011111111111111111111111111
111111111111111111111111111111111111111111000111110000200111113355551111110000201111111101101111111100041111111111111111111111111111111111111111
111111111111111110001111111110101111100010201111102233311111100054500011111133322011111020100011111010111111111000111111111111111111111111111111
111111111111111111111111111111111111110000000111110001000111110553550111111000201111110555550111110004000111111111111111111111111111111111111111
111111111111100111111111102200010001100113300201110103311211113101114011130300011011103102000011112111111001102000000201100011111001111111111111
111111111111111111111111110000000111110105550111110000501111111010501111111010500111110500510111110135024111110000111111111111111111111111111111
111111111111111111100011111110001011111100000011111101121111111031020011111352021011111301020011110051021011113331040011111111111111111111111111
111111111111111111111111111111111111111110001111111042101111111052300111111001000111111131011111111100011111111111111111111111111111111111111111
111111111111111111111111100100001111100002220011100111420011133311201111100310201111113010201111113010001111113050001111111111111111111111111111
111111111111110011111111100010001111100010101111102100503111102001013011151101013011100000010511111111210011111110040011111110050011111111111111
111111111111111111111111110041111111110120111111110100103111110120000111110100100111110120151111110101100111110303000111111110001111111111111111
111111111111110001111111110101040111110222210111110201050111110103021111110310130111110003100111111310000111111300011111111001111111111111111111
111111111111111111111111100011111001100000000201110111111001132202001011133333000011112111111001102000400001100011111111111111111111111111111111
111111111111111000000111111023500111111121101111111003301111111005321111111103301111111121121111111104201111111111001111111111001111111111111111
111111111111111111111111100000011111100202010001102020022101111111010001110001013311110200003311111211111011110013300001110403310001111111111111
111111111111111111111111111111111111111134011111111151220111111000000111111000100111111131101111111100001111111111111111111111111111111111111111
111111111111111110010011111100502011111005010011110050010111110501110111113011000111111010011111100000111111104011111111111111111111111111111111
111111111111111110010011111100500011111005010011110050010111110501110111113011000111111010011111110020111111110411111111110011111111111111111111
111111111111111111111111111110010011111102300011111023010011110230010111102301110111103011110111112111110011110000000011114011111111111111111111
111111111111111111111111111110001111111110000001111111311241100000300011101011311211101010333001101202020201100011111111111111111111111111111111
111111111111111000000111111211110111110200000111110100110111110035310111111154500011111035310011111010010111111022110111111110000111111111111111
111111111111100011100011102511152011100500050011110501050111110335330111110501050111100500050011102511152011100011104011111111111111111111111111
111111111111111111111111111110000011110323232011110232323011110321132011110231123011110323232011110232323011114000011111111111111111111111111111
111111111111111111001001100300230201101132301001101023111011101230301011100310032011111211121001110200000001110401111001111111111111111111111111
111111111111111111111111111100000111110355550111110500050111110501050111110501450111110555520111110000000011111111100011111111111111111111111111
111111111111111111111111111100000111110355550111110100050111110101050111110101450111110155520111110000000011111111100011111111111111111111111111
111111111111111111100111100020202111100333330111112322232111110314130111112322232111110333330011112020200011110011111111111111111111111111111111
111111111111111111111111111111111111111000001111111235321111111050500111111230324111111050501111110235321111110000001111111111111111111111111111
111111111111111111111111111111111111100011110011100000000011110111110011112104010111102031212001101030200001103331111111111111111111111111111111
111111111111111111111111100010301111100000301111111011511111111000311111111011300111111210000011110200202011110401111111111111111111111111111111
111111111111111111111111111111111111111111300111111000000111111355101111111104100111111122000111111101110111111100000111111111111111111111111111
111111111111111111111111111111111111110000001111100111101111100100100111100133550111102200100011100100104011111111111111111111111111111111111111
111111111111111111111111111111111111111000001111111012201111111014001111111055501111111050501111111050501111111130311111111111111111111111111111
111111111111100110010001100000000201100112111011110113301011110103321211110103303011112121111011102000400011100011111111111111111111111111111111
111111111111100110010001102200000201100110111211110133331011110133330011110001112111112101000111102004020111100011111111111111111111111111111111
111111111111111111111111111111111111104011111111102000002011112111131011100000333011102020131111111110000111111111000111111111111111111111111111
111111111111111000001111111011100011100400122011101110101111100053100111112153000111100100355111102121333011100001002011111100011111111111111111
111111111111111111111111110001111111110000242011111011511011110235333011110000302011111113115111111100202011111100000011111111111111111111111111
111111111111111111111111111111111111111111000111111002220111111001340111111535551111111000300111111110000111111111111111111111111111111111111111
111111111111111111111111111111111111111111100111103333330111101010102011100020201011111121202411111100000111111111111111111111111111111111111111
111111111111110000000111110150310111110050500111111055501111111100011111111055501111110050500111110120510111110004000111111111111111111111111111
111111111111111111111111111111111111110000000011110555555011113540005311110255552011110000000011111110011111111111111111111111111111111111111111
111111111111111111111111111111111111111100111111110000000011110555555011113140001311110255552011110000000011111111001111111111111111111111111111
111111111111111111111111110000001111110255551111110050034111110050001111111055551111110020031111110050030111111255550111111000000111111111111111
111111111111111111111111110000000111110113112111110103030111110123110111110320110111112113112011100000002411100010010011111111111111111111111111
111111111111111111111111111111111111110133310111110505050111110505050111110505050111110022200111111104011111111111111111111111111111111111111111
111111111111111111111111111111111111110003000111110503050111110503050111110535350111110222220111111104011111111111111111111111111111111111111111
111111111111111111111111111111111111110401111111110101111111110221000111110233010111110513112111110330002011111000100011111111111111111111111111
111111111111111111111111111111111111111100111111110202020111110133310111110054500111110133310111110202020111111110011111111111111111111111111111
111111111111111111111111111000100111111000220111111101100111111100101111111122133111111130433111111121100111111100001111111111111111111111111111
111111111111111111111111111111111111111103000111111034320111111013211111111012011111111020111111111000111111111111111111111111111111111111111111
111111111111111111111111111111111111110000000111110110110111110130310111110201000111110132310111110112210111110000014111111111111111111111111111
111111111111111111111111111111111111111000100111111003330111111121000111111020000111111021111111111041111111111111111111111111111111111111111111
111111111111111111111111111111111111111100111111111033300111111000310111111212110111110202040111110000011111111111111111111111111111111111111111
111111111111111111111111111111111111111111111111110010033311110222140011110000110111111100000111111111100111111111111111111111111111111111111111
111111111111111111111111111111111111111001001111111000001111111000001111111111011111111004001111111025531111111001001111111111111111111111111111
111111111111111111111111111111111111111111111111111333001111111024201111111101100111111100200111111100100111111111111111111111111111111111111111
111111111111111111111111111111111111111111111111111001001111110002242011110010333011110010010011111111111111111111111111111111111111111111111111
111111111111111111111111111111111111111111000111111100003111111102013111110022133011110002000011111114011111111111111111111111111111111111111111
111111111111110001111111110300000011113331110011113330000011111110010011111111011111111102020111111102020111111102220111111100400111111111111111